G,G,G,G,G,G,G,G,G,G,G,G,G,G,G,G,G,G,G,G,G,G,G,G,G,G,G,G,G,G,G,G,G,G,G,G,G,G,G,G,G,G,G,G,G,G,G,G,G,G,G,G,G,G,G,G,D,D,W,W,W,W,D,D,D,G,G,G,G,G,G,G,G,G,G,G,G,G,G,G,G,G,G,G,G
G,G,G,G,G,G,G,G,G,G,G,G,G,G,G,G,G,G,G,G,G,G,G,G,G,G,G,G,G,G,G,G,G,G,G,G,G,G,G,G,G,G,G,G,G,G,G,G,G,G,G,G,G,G,G,G,D,D,W,W,W,W,D,D,D,G,G,G,G,G,G,G,G,G,G,G,G,G,G,G,G,G,G,G,G
G,G,G,G,G,G,G,G,G,G,G,G,G,G,G,G,G,G,D,D,G,G,G,G,G,G,G,G,G,G,G,G,G,G,G,G,G,G,G,G,G,G,G,G,G,G,G,G,G,G,G,G,G,G,G,G,D,D,W,W,W,W,D,D,D,G,G,G,G,G,G,G,G,G,G,G,G,G,G,G,G,G,G,G,G
G,G,G,G,G,G,G,G,G,G,G,G,G,G,G,G,G,D,D,D,D,G,G,G,G,G,G,G,G,G,G,G,G,G,G,G,G,G,G,G,G,G,G,G,G,G,G,G,G,G,G,G,G,G,G,G,D,D,W,W,W,W,W,D,D,G,G,G,G,G,G,G,G,G,G,G,G,G,G,G,G,G,G,G,G
G,G,G,G,G,G,G,G,G,G,G,G,G,G,G,G,G,D,D,D,D,D,G,G,G,G,G,G,G,G,G,G,G,G,G,G,G,G,G,G,G,G,G,G,G,G,G,G,G,G,G,G,G,G,G,G,D,D,W,W,W,W,W,D,D,G,G,G,G,G,G,G,G,G,G,G,G,G,G,G,G,G,G,G,G
G,G,G,G,G,G,G,G,G,G,G,G,G,G,G,G,G,D,D,W,D,D,D,G,G,G,G,G,G,G,G,G,G,G,G,G,G,G,G,G,G,G,G,G,G,G,G,G,G,G,G,G,G,G,G,G,D,D,W,W,W,W,W,D,D,G,G,G,G,G,G,G,G,G,G,G,G,G,G,G,G,G,G,G,G
G,G,G,G,G,G,G,G,G,G,G,G,G,G,G,G,D,D,W,W,W,D,D,D,G,G,G,G,G,G,G,G,G,G,G,G,G,G,G,G,G,G,G,G,G,G,G,G,G,G,G,G,G,G,G,G,D,D,W,W,W,W,W,D,D,G,G,G,G,G,G,G,G,G,G,G,G,G,G,G,G,G,G,G,G
G,G,G,G,G,G,G,G,G,G,G,G,G,G,G,D,D,D,W,W,W,W,W,D,D,G,G,G,G,G,G,G,G,G,G,G,G,G,G,G,G,G,G,G,G,G,G,G,G,G,G,G,G,G,D,D,D,W,W,W,W,W,W,D,D,D,D,G,G,G,G,G,G,G,G,G,G,G,G,G,G,G,G,G,G
G,S,G,G,G,G,G,G,G,G,G,G,G,G,D,D,D,D,W,W,W,W,W,W,D,D,D,G,G,G,G,G,G,G,G,G,G,G,G,G,G,G,G,G,G,G,G,G,G,G,G,G,G,G,G,D,D,D,D,W,W,W,W,W,W,D,D,D,G,G,G,G,G,G,G,G,G,G,G,G,G,G,G,G,G
G,S,G,G,G,G,G,G,G,G,G,G,G,D,D,D,D,D,W,W,W,W,W,W,W,D,D,G,G,G,G,G,G,G,G,G,G,G,G,G,G,G,G,G,G,G,G,G,G,G,G,G,G,G,G,D,D,D,D,W,W,W,W,W,W,D,D,G,G,G,G,G,G,G,G,G,G,G,G,G,G,G,G,G,G
G,S,G,G,G,G,G,G,G,G,G,G,G,D,D,D,D,D,W,W,W,W,W,W,W,W,D,D,G,G,G,G,G,G,G,G,G,G,G,G,G,G,G,G,G,G,G,G,G,G,G,G,G,G,G,G,D,D,D,W,W,W,W,W,W,W,D,D,G,G,G,G,G,G,G,G,G,G,G,G,G,G,G,G,G
G,S,G,G,G,G,G,G,G,G,G,G,G,D,D,D,D,D,W,W,W,W,W,W,W,W,D,D,G,G,G,G,G,G,G,G,G,G,G,G,G,G,G,G,G,G,G,G,G,G,G,G,G,G,G,G,G,G,D,D,W,W,W,W,W,W,D,D,G,G,G,G,G,G,G,G,G,G,G,G,G,G,G,G,G
G,S,G,G,G,G,G,G,G,G,G,G,G,G,D,D,D,D,D,W,W,W,W,W,W,D,D,D,G,G,G,G,G,G,G,G,G,G,G,G,G,G,G,G,G,G,G,G,G,G,G,G,G,G,G,G,G,G,D,D,W,W,W,W,W,W,D,D,G,G,G,G,G,G,G,G,G,G,G,G,G,G,G,G,G
G,S,G,G,G,G,G,G,G,G,G,G,G,G,G,G,D,D,D,D,D,W,W,W,D,D,D,D,G,G,G,G,G,G,G,G,G,G,G,G,G,G,G,G,G,G,G,G,G,G,G,G,G,G,G,G,G,G,D,D,W,W,W,W,W,W,W,D,D,G,G,G,G,G,G,G,G,G,G,G,G,G,G,G,G
G,S,G,G,G,G,G,G,G,G,G,G,G,G,G,G,G,G,D,D,D,D,D,D,D,G,G,G,G,G,G,G,G,G,G,G,G,G,G,G,G,G,G,G,G,G,G,G,G,G,G,G,G,G,G,G,G,G,D,D,W,W,W,W,W,W,W,W,W,D,D,G,G,G,G,G,G,G,G,G,G,G,G,G,G
G,S,G,G,G,G,G,G,G,G,G,G,G,G,G,G,G,G,G,G,G,G,G,G,G,G,G,G,G,G,G,G,G,G,G,G,G,G,G,G,G,G,G,G,G,G,G,G,G,G,G,G,G,G,G,G,G,G,D,D,W,W,W,W,W,W,W,D,D,G,G,G,G,G,G,G,G,G,G,G,G,G,G,G,G
G,S,G,G,G,G,G,G,G,G,G,G,G,G,G,G,G,G,G,G,G,G,G,G,G,G,G,G,G,G,G,G,G,G,G,G,G,G,G,G,G,G,G,G,G,G,G,G,G,G,G,G,G,G,G,G,G,G,D,D,W,W,W,W,W,W,W,W,D,D,G,G,G,G,G,G,G,G,G,G,G,G,G,G,G
G,S,S,G,G,G,G,G,G,G,G,G,G,G,G,G,G,G,G,G,G,G,G,G,G,G,G,G,G,G,G,G,G,G,G,G,G,G,G,G,G,G,G,G,G,G,G,G,G,G,G,G,G,G,G,G,G,G,D,D,W,W,W,W,W,W,W,W,D,D,G,G,G,G,G,G,G,G,G,G,G,G,G,G,G
G,S,S,G,G,G,G,G,G,G,G,G,G,G,G,G,G,G,G,G,G,G,G,G,G,G,G,G,G,G,G,G,G,G,G,G,G,G,G,G,G,G,G,G,G,G,G,G,G,G,G,G,G,G,G,G,G,D,D,W,W,W,W,W,W,W,D,D,G,G,G,G,G,G,G,G,G,G,G,G,G,G,G,G,G
G,S,S,G,G,G,G,G,G,G,G,G,G,G,G,G,G,G,G,G,G,G,G,G,G,G,G,G,G,G,G,G,G,G,G,G,G,G,G,G,G,G,G,G,G,G,G,G,G,G,G,G,G,G,G,G,G,D,D,W,W,W,W,W,W,W,D,D,G,G,G,G,G,G,G,G,G,G,G,G,G,G,G,G,G
G,S,S,G,G,G,G,G,G,G,G,G,G,G,G,G,G,G,G,G,G,G,G,G,G,G,G,G,G,G,G,G,G,G,G,G,G,G,G,G,G,G,G,G,G,G,G,G,G,G,G,G,G,G,G,G,G,G,D,W,W,W,W,W,W,W,W,D,D,G,G,G,G,G,G,G,G,G,G,G,G,G,G,G,G
G,S,G,G,G,G,G,G,G,G,G,G,G,G,G,G,G,G,G,G,G,G,G,G,G,G,G,G,G,G,G,G,G,G,G,G,G,G,G,G,G,G,G,G,G,G,G,G,G,G,G,G,G,G,G,G,G,D,D,W,W,W,W,W,W,W,W,D,D,G,G,G,G,G,G,G,G,G,G,G,G,G,G,G,G
G,S,G,G,G,G,G,G,G,G,G,G,G,G,G,G,G,G,G,G,G,G,G,G,G,G,G,G,G,G,G,G,G,G,G,G,G,G,G,G,G,G,G,G,G,G,G,G,G,G,G,G,G,G,G,G,G,D,D,W,W,W,W,W,W,W,W,D,D,G,G,G,G,G,G,G,G,G,G,G,G,G,G,G,G
G,S,G,G,G,G,G,G,G,G,G,G,G,G,G,G,G,G,G,G,G,G,G,G,G,G,G,G,G,G,G,G,G,G,G,G,G,G,G,G,G,G,G,G,G,G,G,G,G,G,G,G,G,G,G,G,G,D,D,W,W,W,W,W,W,W,W,D,D,G,G,G,G,G,G,G,G,G,G,G,G,G,G,G,G
G,S,G,G,G,G,G,G,G,G,G,G,G,G,G,G,G,G,G,G,G,G,G,G,G,G,G,G,G,G,G,G,G,G,G,G,G,G,G,G,G,G,G,G,G,G,G,G,G,G,G,G,G,G,G,G,G,D,D,W,W,W,W,W,W,W,D,D,G,G,G,G,G,G,G,G,G,G,G,G,G,G,G,G,G
G,S,G,G,G,G,G,G,G,G,G,G,G,G,G,G,G,G,G,G,G,G,G,G,G,G,G,G,G,G,G,G,G,G,G,G,G,G,G,G,G,G,G,G,G,G,G,G,G,G,G,G,G,G,G,G,G,G,D,D,W,W,W,W,D,D,G,G,G,G,G,G,G,G,G,G,G,G,G,G,G,G,G,G,G
G,S,G,G,G,G,G,G,G,G,G,G,G,G,G,G,G,G,G,G,G,G,G,G,G,G,G,G,G,G,G,G,G,G,G,G,G,G,G,G,G,G,G,G,G,G,G,G,G,G,G,G,G,G,G,G,G,G,D,D,W,W,W,W,W,D,D,G,G,G,G,G,G,G,G,G,G,G,G,G,G,G,G,G,G
G,S,G,G,G,G,G,G,G,G,G,G,G,G,G,G,G,G,G,G,G,G,G,D,D,W,D,D,D,G,G,G,G,G,G,G,G,G,G,G,G,G,G,G,G,G,G,G,G,G,G,G,G,G,G,G,G,G,G,D,D,W,W,W,W,W,D,D,G,G,G,G,G,G,G,G,G,G,G,G,G,G,G,G,G
G,S,S,G,G,G,G,G,G,G,G,G,G,G,G,G,G,G,G,G,G,G,D,D,W,W,W,D,D,D,D,G,G,G,G,G,G,G,G,G,G,G,G,G,G,G,G,G,G,G,G,G,G,G,G,G,G,G,G,D,D,W,W,W,W,W,D,D,G,G,G,G,G,G,G,G,G,G,G,G,G,G,G,G,G
G,S,S,G,G,G,G,G,G,G,G,G,G,G,G,G,G,G,G,G,G,D,D,D,W,W,W,W,W,D,D,D,D,D,D,D,D,G,G,G,G,G,G,G,G,G,G,G,G,G,G,G,G,G,G,G,G,G,G,D,D,D,W,W,W,W,W,W,D,D,D,D,G,G,G,G,G,G,G,G,G,G,G,G,G
G,S,S,G,G,G,G,G,G,G,G,G,G,G,G,G,G,G,G,G,D,D,D,D,W,W,W,W,W,W,D,D,D,D,D,D,D,D,G,G,G,G,G,G,G,G,G,G,G,G,G,G,G,G,G,G,G,G,G,D,D,D,D,W,W,W,W,W,W,W,D,D,D,G,G,G,G,G,G,G,G,G,G,G,G
G,S,S,G,G,G,G,G,G,G,G,G,G,G,G,G,G,G,G,G,D,D,D,D,W,W,W,W,W,W,W,W,W,W,W,W,D,D,D,D,G,G,G,G,G,G,G,G,G,G,G,G,G,G,G,G,G,G,G,G,D,D,D,D,W,W,W,W,W,W,W,W,D,D,G,G,G,G,G,G,G,G,G,G,G
G,S,G,G,G,G,G,G,G,G,G,G,G,G,G,G,G,G,G,D,D,D,D,D,W,W,W,W,W,W,W,W,W,W,W,D,D,D,D,G,G,G,G,G,G,G,G,G,G,G,G,G,G,G,G,G,G,G,G,G,G,D,D,D,W,W,W,W,W,W,W,W,W,D,D,G,G,G,G,G,G,G,G,G,G
G,S,G,G,G,G,G,G,G,G,G,G,G,G,G,G,G,G,G,D,D,D,D,D,W,W,W,W,W,W,W,W,W,W,D,D,D,G,G,G,G,G,G,G,G,G,G,G,G,G,G,G,G,G,G,G,G,G,G,G,G,G,D,D,W,W,W,W,W,W,W,W,W,D,D,G,G,G,G,G,G,G,G,G,G
G,S,G,G,G,G,G,G,G,G,G,G,G,G,G,G,G,G,G,G,D,D,D,D,D,W,W,W,W,W,W,W,W,D,D,D,G,G,G,G,G,G,G,G,G,G,G,G,G,G,G,G,G,G,G,G,G,G,G,G,G,G,D,D,W,W,W,W,W,W,W,W,W,D,D,G,G,G,G,G,G,G,G,G,G
G,S,G,G,G,G,G,G,G,G,G,G,G,G,G,G,G,G,G,G,G,G,D,D,D,D,D,W,W,W,D,D,D,D,D,G,G,G,G,G,G,G,G,G,G,G,G,G,G,G,G,G,G,G,G,G,G,G,G,G,G,G,G,D,D,W,W,W,W,W,W,W,W,W,D,D,G,G,G,G,G,G,G,G,G
G,S,G,G,G,G,G,G,G,G,G,G,G,G,G,G,G,G,G,G,G,G,D,D,D,D,D,D,W,D,D,D,D,D,G,G,G,G,G,G,G,G,G,G,G,G,G,G,G,G,G,G,G,G,G,G,G,G,G,G,G,G,G,D,D,W,W,W,W,W,W,W,W,W,D,D,G,G,G,G,G,G,G,G,G
G,S,G,G,G,G,G,G,G,G,G,G,G,G,G,G,G,G,G,G,G,G,G,G,D,D,D,D,D,D,D,G,G,G,G,G,G,G,G,G,G,G,G,G,G,G,G,G,G,G,G,G,G,G,G,G,G,G,G,G,G,G,G,D,D,W,W,W,W,W,W,W,W,W,D,D,G,G,G,G,G,G,G,G,G
G,S,S,G,G,G,G,G,G,G,G,G,G,G,G,G,G,G,G,G,G,G,G,G,G,G,G,G,G,G,G,G,G,G,G,G,G,G,G,G,G,G,G,G,G,G,G,G,G,G,G,G,G,G,G,G,G,G,G,G,G,G,G,D,D,W,W,W,W,W,W,W,W,W,D,D,G,G,G,G,G,G,G,G,G
G,S,S,G,G,G,G,G,G,G,G,G,G,G,G,G,G,G,G,G,G,G,G,G,G,G,G,G,G,G,G,G,G,G,G,G,G,G,G,G,G,G,G,G,G,G,G,G,G,G,G,G,G,G,G,G,G,G,G,G,D,D,W,W,W,W,W,W,W,W,W,D,D,G,G,G,G,G,G,G,G,G,G,G,G
G,S,G,G,G,G,G,G,G,G,G,G,G,G,G,G,G,G,G,G,G,G,G,G,G,G,G,G,G,G,G,G,G,G,G,G,G,G,G,G,G,G,G,G,G,G,G,G,G,G,G,G,G,G,G,G,G,G,G,D,D,W,W,W,W,W,W,W,W,W,D,D,G,G,G,G,G,G,G,G,G,G,G,G,G
G,S,G,G,G,G,G,G,G,G,G,G,G,G,G,G,G,G,G,G,G,G,G,G,G,G,G,G,G,G,G,G,G,G,G,G,G,G,G,G,G,G,G,G,G,G,G,G,G,G,G,G,G,G,G,G,G,D,D,W,W,W,W,W,W,W,W,W,D,D,G,G,G,G,G,G,G,G,G,G,G,G,G,G,G
G,S,G,G,G,G,G,G,G,G,G,G,G,G,G,G,G,G,G,G,G,G,G,G,G,G,G,G,G,G,G,G,G,G,G,G,G,G,G,G,G,G,G,G,G,G,G,G,G,G,G,G,G,G,G,G,G,D,D,W,W,W,W,W,W,W,W,W,D,D,G,G,G,G,G,G,G,G,G,G,G,G,G,G,G
G,S,S,G,G,G,G,G,G,G,G,G,G,G,G,G,G,G,G,G,G,G,G,G,G,G,G,G,G,G,G,G,G,G,G,G,G,G,G,G,G,G,G,G,G,G,G,G,G,G,G,G,G,G,G,D,D,W,W,W,W,W,W,W,W,W,D,D,G,G,G,G,G,G,G,G,G,G,G,G,G,G,G,G,G
G,S,S,S,G,G,G,G,G,G,G,G,G,G,G,G,G,G,G,G,G,G,G,G,G,G,G,G,G,G,G,G,G,G,G,G,G,G,G,G,G,G,G,G,G,G,G,G,G,G,G,G,G,D,D,W,W,W,W,W,W,W,W,W,D,D,G,G,G,G,G,G,G,G,G,G,G,G,G,G,G,G,G,G,G